---------------------------------o----------------------------------------------------------------------------------------------------------------------------------------------------------------------
-------------------------------------------------------------------------------------------------------------------------------------------B------------------------------------------------------------
--------------------------------------------------------------------------------------------------------------------------------------------------------------------------------------------------------
-----------------------------------------------------------------------------------------------------------------------------------------B----------------------B---------------------------------------
--------------------------------------------------------------------------------------------------------------------------------------------------------------------------------------------------------
---------------B-------------------------------------------------------------X------------------------------------------------------------------o-------------------------------------------------------
----------------------------------------o-----------------------------------XX--------------------------------------------------------------------------------------------------------------------------
---------------------------------------------------------------------------XXX---o-------------------------------------------------o-------------------------------------------------------------------v
--------------------------------------X-----------------------------?-----XXXX-------------------------------------------------------?---------------------------BBB----------X------------------------f
-------------------------------------------------------X-----------------XXXXX-------------------------------------------------------------------------------------------------------------------------f
------------------------------------------------------------------------XXXXXX-------------------------------------------------------------------------------------------------------------------------f
--------------------------?--------------------------------------------XXXXXXX------------------?---------------------------------------------------------o------------------------M-------------------f
----------------------------------------------????????----------------XXXXXXXX-------------------------------------------------------------------------------------------------T-----------------------f
---------------------------------------------------------------------XXXXXXXXX-------------------------------------------------------------------------------------------------|-----------------------f
mE---X--------------------E--E--------------------------------------XXXXXXXXXXX--X------------------------------------------------------------------------------E----------E---|--------------?--------X
XMXXXXXXXXXXXXXXXXXXXXXXXXMXXBXXXX?XXXXXXXXXX-----XXXX-----XXX-XXXXXXXXXXXXXXXXXXXX--XXXXXXXXXXXXXXXXXXXXXXXXXXXXXXXXXX----XXXXXXXXXXXX--------XXXXXXXXXXXXXXXXXBXXXXXXXXXXMXXX|XXXXXXXXXXXXXXXXXXXXXXXX
