--------------------------------------------------------------------------------------------------------------------------------------------------------------------------------------------------------
oE-X-BEMXB-X-B-?XEB-E-XXXM-BX-MXMEX?BXMMXo---oXXXXBM-B?TM--MXMBMB?MMXBMXE?EoXMMB---XBTX--o?XT?-TXT--?XB---XXX-----MX-XoXXEBMTX-TBTX?M----o-B-?MX?T-X-TXXB-ETEM?EB-BTE-B-TXBBBXXX-oMBBXM-E-oBB-XT-X-BoBo
MXXEoEX-oX?B?-M--XXMXTEXo-MXBB---X?-XM--?BBXBMBXX---B--B-X------E---XM-XX-XXX--BX-XEMXXBBB--X-EXB|---MB--XoMX?B----X??XX-MX-X--X-XM--EBBoo-?-----B-BMX-B-BTXM--TXEXXXBBMX?oBBMM?o--X-X-XXX?BXEXX-BoX--B
-XBM-TXBM--B-B--BXo-oXX?-M-X-M--MX--M-X?-MEMM-B-B-TXX-E-XBXBMEB-X-BX?--BX-o-o-MX-XEX---MBX-XBoXB-XB-X---BB--M-BoB--X--?XM-ET?XM-E---oBBX-?M-XMMXEBEB-XB-oBXX--BXXXB-M-o---BMo----MXE-BBX?M-XBTXXEXB--MB
BX?--X---MXBE?-XBXX-BM?-E-B-B-Eo-?o--?X-B-B----XX-B-oXB-BXMM-TX-XBM--TBM--BTo--BBEXX-XB-BBMMB?XBB-oBMo---M-M-BB-X-?-M--M-BXB-X-XX--?X-B?X--T---XBXXXToM??---M-B--X?--X-MMX--B-XMB-MMBBXX--XoXX--X?XX--o
-X-EB?X?--BBX-oBXXXBM--BXBBX-XXM?-BXM-X-o-Xo-?EXoB--XX-o----EBXoBX-MoX--M-BBX?-MXXE-??-MX---B-Mo--XB-X-BT-M--?---?----M-B-BBT--X-Bo--M--BXBX--X?ME--BB---E---BXXMX-M-X---X-MM-B--E--o?XBTBBBB--MX---BXX
XXXXB-X-BXBMBXX?oBMo-EMXX--M--B--B-X---B-X-XM-T-XXMXX--XXMB-XX--XB---X-X---M-----M?M--B--XTTME--M-MXBBB-XB-T--X---?-oB-B-B-BB?TMB-X----B-X-oE?M--X--XBB-XX---B-B-BX--ETX-X?--XEBB?MMo--XXM-X-oB-?oBX-?-
X-M-M--BM-?-BXX-XX-X-X-?MM---MB?XX--B-TBM-B--XXBMX-BMM-o--?ooBBXXXXEXX-XX-M-BX?-B----MX--BXX-XX--X-MXX--X-X|BXEBXB-XX-BB??-BB-X-EoBBXXBB--BoX----BE-oM-M--BMTB-XXB?XBBBXMB--MBX-M----M-o?--BBMX--MX---Xv
MX-----?-M-?--M?oEXBBE----EM?-?-XXoXEoX--?MEX-XB-XMB--M--B-E-E-o?X-XXE-BXT-BM--XM--E--X?X---EX--XB----E-XMXXBBX-X---MX-X--XMX--TBM-XMMXB-TB-M-X?MBTXB-B-T---XB-BMX-XB-M--BBE-M?B-B-BB-BB-oX-X-MM---BXMEf
-X--XXX---T-----MXE--?XTE-M--M-?--MXT-BXM--X??MX---M-B-oX-XB-XBB-X?-XXBE-XB--o-X-EBTMB--M-?-MX-B-XoEB-X---X-B-MTBXBB---?BEX--X-XX--B--Mo-XXB-EX--EXEBXo-XBT----X-XX-----MMEXE---EXBXM----?oX----BB-XM-?f
TXM-EM-MEBB-X-MT-XXB--BBXX--E-X-T---XB-X-MXE---MEXM-?MBEBoXBXX?XXo-oMMXX-o---XX-BX-X--XB-B-X--?-B-EXBX??o-M?MX-XXEB-B-B-XTo--EBXBX-M?M----X-BXM-oXEXX-oX--X-X--M-X-BBT-M--M-X?X-X-MB--XMB-XXTM-o?EX--B-f
XB--M-M-XMMXoo-XMMo-TB-XB-TBB--XXB?To--M?-XTBT--X--?--XXBXEX-M-E-XEX--XB-ET-B-?XBB-X?---XMBMEX-BM-XBXM--MX---B-oEX?-EB-B-|E-BXX-BM------TXBooB-B--XE?-?X-XBBB----BX-M|T-Xo--M-B-BX-MBX--E-X?X--X-XEXXX-f
-----------o?X-----MX-BB-BX-XMXBo--XB-E--T?XBXBM?-M-XM?XBMMBT-oBEBXMB--M-?B--X-?XXM--MXE--B-X-XX--XB--TX-B-X--BoXB-MX-BXBBB??XXoB-?MBT-XBMBX?XXETo-X---?-B-EMTX-?BX--XB?BXX---XXMX--X--MM-X--BTXXXTB--of
--------X-oX-XMMEXB-BXX--B?---B-X--BXBXXTB-BXMM--T-B---Xo--oX-?B?XB--T?---??-BM-?M--X--X--?X-EM-XoXX--XXXXXMXBEBXXo-BBXE-----XXBXo--BXEBE--E-o?XX-XMT-M-XB-M-XBE--BMoX--?XX-X-B--oMX-X---MBE?MXoBEXX-?Xf
m-------oBMXMX--X?M----TXB-XXXXMX-XX--XBXX-XX--o-|?--X--o---MT----o-?X-XTM--?--X--MBB-TBB--?XX-M-BMMMTX?X-----X-B?BB-o-X?-X---MMXX-X--XoXTXX-o--B-X-XM-B-M----??-X----?--XBTXM-B?--X--M-X-XM--XB??----MX
XXXXXXXXXXXXXXXXXXXXXXXXXXXXXXXXXXXXXXXXXXXXXXXXXXXXXXXXXXXXXXXXXXXXXXXXXXXXXXXXXXXXXXXXXXXXXXXXXXXXXXXXXXXXXXXXXXXXXXXXXXXXXXXXXXXXXXXXXXXXXXXXXXXXXXXXXXXXXXXXXXXXXXXXXXXXXXXXXXXXXXXXXXXXXXXXXXXXXXXX
