----------------------------------------------------------------------------------------------------------------------------------------------------------------M---------------------------------------
--------------------------------------------------------------------------------------------------------------------------------------------------------------------------------------------------------
--------------B-----?-------M--------------------------BB----------------B--X------X-M----------X?-----------------M----B------------------------------------B------------------------------------------
------X---o---------------------------B---------------?-----------B---BB-M--B---B-------------------X--------M--------------------M----B--BX-------M---------------------B------------------------------
------------------------------?------------o----------------X--------M-----MX-X--------------------M-----X------X----------------------X----X---------------?------------?------------------------------
---B------?------------------M---?---------------------------------------B------------X----------------------------------------Bo---X------------------------X--------------------------------B?--------
------B-----X---------o---------------?------------X------------------------------?--------------------------B------------X------X---X-----------------B-----------BBX-----------------------------?----
------?-----M---------------?-------------X----?------------BB----------------------B--X-----------X---B-------------------------B-XB------------------------------X--------------oBX--BB--M-----------v
---------------------------------?------------B----B-------------B-----X-B-------X-----------X-----------------------------------M-----X--X----------------T--B--BX---M--XM----------B------X-------?--f
------------X------------------------------B----------?------------B---T--M--------X-X----X----------M---------X---X--B--------B-----X------------??-------X------M-------------------------X----------f
----------------XB------X--X-------M--X------?----------------MX------oXX-----X----------------o----------X--------X---X-M-----X-?------X--B-X-----------------X----------------------------B---------Xf
-X---X--------------B------------------X----X---X---------------------------X-X---B--M---B---X----X-?-M---------------------M--X---X-----M---X--------------B----X----------------B--X-X----?-----B----f
------------X---------------------X---------o------------X---XX---------X---X----------------------X----------B-----B---B-------------------------X--------X---------B-X------------B---B--X---?-------f
-----------B------B-----X----X--X-XXX-----------X--------?------B--B-B-----------X--X-----?------------X-X------------?--------------X-M-X-------XX----X----X--B-B----------X---M--B-T-----B-------X---f
m-------X-----------X--------XB--X--B-X-X-X----X-X----?------?-------------XXX--X--------X--------XX-X-X--X--oXX-----X---XX--X-BXX------X-----M-X--BM--------------X-------B--X--X-B-XX---B-XX--X-X----X
XXXXXXXXXXXXXXXXXXXXXXXXXXXXXXXXXXXXXXXXXXXXXXXXXXXXXXXXXXXXXXXXXXXXXXXXXXXXXXXXXXXXXXXXXXXXXXXXXXXXXXXXXXXXXXXXXXXXXXXXXXXXXXXXXXXXXXXXXXXXXXXXXXXXXXXXXXXXXXXXXXXXXXXXXXXXXXXXXXXXXXXXXXXXXXXXXXXXXXXX
