-----------------------------------------------------------------------------------------------------------------------------------------------------------M-----------B--------------------------------
--------------------------------------------------------------------------------------------------------------------------------------------------------------------------------------------------------
-----------------------------?-------------------------BBBBBBBB-----------------------------------------------------------------------------------------------------------------------------------------
-------------------------------------------------------------------------------------------------------------------------------------------X------------------------------------------------------------
---------------------------------------------------------------------------------------------------------------------------------------------BBBBBB-----------------------------------------------------
--------------------------------------------------------------------------------------------------------------M---------------------X----------------------------------------------------o--------------
-------------------------------------------------------------------?----------------------------------------------------------------XX------------------------------------------------------------------
-----------------------X------------------------------------------------------??------B---------------------------------------------XXX----------------------------------------------------------------v
----------------------XX------------------------------------------------------------------------------------------------------------XXXX-----------------------T---------------------------------------f
-o-------------------XXX-T-----------------------------------------------------------------o--XXXXXXXX----------------------BXXB----XXXXX----------------------|---------------------------------------f
--------------------XXXX-|----------------------------------------------------------------------------------------------------------XXXXXX------------------T--|-----------?---------------------------f
-------------------XXXXX-|-----?X?BX?XX--------------------------------------------------o--------------------------T---------------XXTXXXX-----------------|--|---------------------------------------f
------------------XXXXXX-|--------------------------------------------------------------------------------T-------T-|---------------XX|XXXXX----------------|--|----------------------------------T----f
-----------------XXXXXXX-|--------------------------------------------------------------------------------|-------|-|--------o------XX|XXXXXX---------------|X-|----------------------------------|----f
m----E----------XXXXXXXXM|----E------M--------------------------------------------------------------------|-------|-|---------------XX|XXXXXXX--------------|XX|----------------------------------|B--XX
X----?--XXXXXXXXXXXXXXXX-|XXXXXXXXXXXXXXXXXXXXXXXXXXXXXXXXXXXXXXXXXXXXXXXXXXXXXXXXXXXXXXXXXXXXXXXXXXXX-XXX|XXXXXXX|X|XXXXXXXX-X--XXXXX|XXXXXXXX-----X-------|XX|XXXXXXXXXX-----XXXXXXXXXXXXXXXXXXX|XXXXX
