--------------------------------------------------------------------------------------------------------------------------------------------------------------------------------------------------------
------------------------------------------------------------------------o-------------------------------------------------------------------------------------------------------------------------------
----------o---------------------------------------M-------B--------X------B---------------M-------------X----------------------------------------X---------------------B-------------o-----B--------o---
-----------------?------------?---------o--------------------?-----?--------------o-------------------------------------M--------------X-------------------X----------------------X---B---B-------------
--?--------------------------------------------?-----------------------X----B--------?--------------B-------------------------------X-----------------?----o-----B------M---------B---------------------
------------B---------------?--------?----X------M------------o------------X-------------X----------X--B------------?----------------------------------------X----------------X----X--------------------
-------------?-----o---X--------M-----------------------------X----B----------M---XX--o----------B-B---o----------------------B-?-------------X----------------------------M-------?--------------------
---------------------------X--X-----------------------?----------------------------M----------------------------X--------X-----------------------------------X------B-------------M------BB----X-------v
-------------------?----------X-------X----------------------X--------BB-------M---------------M-----------B---M----------?-?------------------------o---------X-B--------------B--------------------X-f
------------------X-?B------X------------------X-------------?--------------------------o-----------B------------B-----------------------------------------X----X------B-B-----------X-------?---------f
-----------------------------------------------X-------------o-----X-----M---------o---------------X------------T-X-X------------B--------X-------?-X-X-T--------X-------------M--------------------X--f
--------------X---?-------X------------?------X-----------------------?------X-----o---o------X-X---------------XXX----BB--X--------X-------------------XX---------------B-X------M-------------B------f
------------BX---------------------------X---XX----------X----X---X-XX-B-X-X-----------X----?----?B-------X---------X-X--?----X---XB-X--X-------X--?-------------X------------X----------------X-X-----f
-----------X-------X------X----------------X------------------B----XX--X-------X-X-MX-----------X------------X--XB---B------X--------X----X--X---X-----X--M-------------------------------------X----X-f
m-------B-X------X-X---X-------------------X--X-X--X-X--X--------X-------X-XM-------------X--X----XX----X-XXX-------X----XXX--B-X--X--X-XX-----X-X-XX----------X------X----X-XXX----X-----------X------X
XXXXXXXXXXXXXXXXXXXXXXXXXXXXXXXXXXXXXXXXXXXXXXXXXXXXXXXXXXXXXXXXXXXXXXXXXXXXXXXXXXXXXXXXXXXXXXXXXXXXXXXXXXXXXXXXXXXXXXXXXXXXXXXXXXXXXXXXXXXXXXXXXXXXXXXXXXXXXXXXXXXXXXXXXXXXXXXXXXXXXXXXXXXXXXXXXXXXXXXX
